11111111111111111111
100000000000000000E1
1000000C000000000001
1000000000000C000001
1000000000C000000001
1P000000000000000001
11111111111111111111
