11111111111111111111
100000000000001000E1
1000000C100000000001
1000000000000C100001
1000000000C100000001
1P000000000000000001
11111111111111111111
