11111111111111111111
100000001111111000E1
1000000C110000100001
1000000000010C100001
1110000000C100000001
1P000000000100000001
11111111111111111111